WWWWW
W_P_W
WW__W
WD__W
WWWWW
END